18 18 18 18 18 18 18 18 18 18 18 18 18 18 18 18 18 18 18 18 18 18 18 18 18 18 18 18 18 18 18 18 18 18 18 18 18 18 18 18 18 18 18 18 18 18 18 18 18 18 
18 18 18 18 18 18 18 18 18 18 18 18 18 18 18 18 18 18 18 18 18 18 18 18 18 18 18 18 18 18 18 18 18 18 18 18 18 18 67 72 72 72 72 72 66 19 19 19 18 18 
18 18 18 18 18 18 18 18 18 18 18 18 18 18 18 18 18 18 18 18 18 18 18 18 18 18 18 18 18 18 28 26 26 26 26 26 26 67 71 51 52 51 51 51 70 66 26 26 29 18 
18 18 18 18 18 18 18 18 18 18 18 18 18 18 18 18 18 18 18 18 18 18 18 18 18 18 18 18 18 18 24 52 51 52 51 52 52 73 69 51 52 51 52 51 68 74 52 52 23 18 
18 18 18 26 26 26 26 26 26 26 26 26 18 18 18 18 18 18 18 18 18 18 18 18 18 18 18 18 18 18 24 51 51 76 51 51 51 61 60 60 56 78 58 60 60 75 52 51 23 18 
18 28 27 1 1 1 1 1 1 1 1 1 1 25 29 18 18 18 18 18 18 18 18 18 18 18 18 18 18 18 24 51 51 52 51 52 52 52 52 76 57 78 59 76 52 52 52 51 23 18 
28 27 1 84 85 85 85 85 85 85 85 86 2 1 25 29 18 18 18 18 18 18 28 26 26 26 26 26 26 26 27 51 51 52 52 52 52 51 51 51 57 78 59 52 51 52 52 51 23 18 
24 1 89 83 91 2 1 1 1 1 1 87 1 1 1 23 18 18 18 18 18 28 27 53 53 53 53 53 53 53 53 53 53 53 53 53 53 53 53 53 53 53 53 53 53 53 53 53 23 18 
24 91 90 83 92 89 1 1 1 1 1 87 1 1 91 23 18 18 18 19 19 24 52 53 53 53 53 53 53 53 53 53 53 53 53 53 53 53 53 53 53 53 53 53 53 53 53 53 23 18 
24 92 2 83 1 90 1 1 1 1 1 87 1 89 92 23 18 19 19 18 19 24 52 53 53 52 52 52 52 52 51 51 52 52 52 53 53 52 51 52 51 52 52 52 52 52 51 52 23 18 
24 1 2 79 80 80 82 10 10 81 80 88 1 90 1 23 18 19 19 19 18 24 8 53 53 7 52 52 52 52 51 51 51 52 52 53 53 51 54 52 52 55 76 55 52 52 52 52 25 29 
24 1 10 10 10 10 11 3 3 9 10 10 10 1 2 23 18 18 19 19 19 24 8 3 3 7 20 21 21 22 51 55 55 54 51 56 58 51 52 51 54 54 54 52 52 52 52 52 52 23 
24 8 3 3 3 3 3 3 3 3 3 3 3 7 1 23 18 18 18 18 18 24 8 3 3 7 23 18 18 24 60 61 60 60 60 57 59 60 60 60 60 60 60 60 56 58 60 60 75 23 
24 11 3 3 3 3 3 3 3 3 3 3 3 7 1 23 18 18 18 18 18 24 8 3 3 7 23 19 18 30 22 61 60 60 67 64 65 66 60 60 60 60 60 60 57 59 60 75 20 31 
24 3 3 3 4 5 5 5 5 5 6 3 3 7 20 31 18 18 18 18 18 24 8 3 3 7 23 18 19 19 30 21 21 22 73 62 63 74 20 21 21 21 21 22 52 52 52 20 18 18 
24 3 3 3 7 1 1 91 1 1 8 3 3 3 25 26 26 26 26 29 18 24 8 3 3 7 23 19 18 18 18 18 18 24 61 60 60 75 23 18 18 19 19 24 52 77 20 31 18 18 
24 5 5 5 1 89 1 92 1 1 89 6 3 3 3 3 3 3 3 23 18 24 8 3 3 7 23 18 18 18 18 18 18 30 21 21 21 21 31 19 19 19 19 30 21 21 31 18 18 18 
30 22 1 1 1 90 1 1 1 2 90 1 1 8 3 3 3 3 3 25 26 27 8 3 3 7 25 26 26 26 26 26 26 26 29 18 18 18 19 19 19 18 19 18 18 19 19 19 19 18 
18 30 21 21 21 21 21 21 21 21 22 1 2 8 3 3 3 3 3 10 10 10 11 3 3 9 10 10 13 89 1 1 91 1 23 18 18 18 18 18 18 18 18 18 18 18 18 18 18 18 
18 18 18 18 18 18 18 18 18 18 30 21 21 21 22 3 3 3 3 3 3 3 3 3 3 3 3 3 7 90 1 89 92 1 23 18 18 18 18 18 18 18 18 18 18 18 18 18 18 18 
18 19 19 19 19 19 18 18 19 19 19 18 18 18 30 21 22 6 3 3 3 3 3 3 3 3 3 3 7 1 1 90 1 20 31 18 18 18 18 18 18 18 18 18 18 18 18 18 18 18 
18 19 19 19 19 19 19 19 19 19 18 19 18 18 18 28 27 1 5 89 5 89 5 89 5 5 5 89 15 1 91 1 20 18 18 18 18 18 18 18 18 18 18 18 18 18 18 18 18 18 
18 18 18 18 19 18 18 18 19 19 19 19 18 18 18 24 1 1 89 90 91 90 89 90 89 91 89 90 1 1 92 2 25 29 18 18 18 18 18 18 18 18 18 18 18 18 18 18 18 18 
18 18 18 18 18 18 18 18 18 18 18 18 18 18 18 24 1 1 90 1 92 1 90 1 90 92 90 1 1 89 2 1 89 23 18 18 18 18 18 18 18 18 18 18 18 18 18 18 18 18 
18 18 18 18 18 18 18 18 18 18 18 18 18 18 18 24 89 89 91 89 89 91 89 91 89 91 89 91 89 90 89 1 90 23 18 18 18 18 18 18 18 18 18 18 18 18 18 18 18 18 
18 18 18 18 18 18 18 18 18 18 18 18 18 18 18 24 90 90 92 90 90 92 90 92 90 92 90 92 90 1 90 20 21 31 18 18 18 18 18 18 18 18 18 18 18 18 18 18 18 18 
18 18 18 18 18 18 18 18 18 18 18 18 18 18 18 24 12 10 10 10 10 10 10 10 10 10 10 10 10 13 1 23 18 18 18 18 18 18 18 18 18 18 18 18 18 18 18 18 18 18 
18 18 18 18 18 18 18 18 18 18 18 18 19 18 18 24 8 3 3 3 3 3 3 3 3 3 3 3 3 7 1 23 18 18 18 18 18 18 18 18 18 18 18 18 18 18 18 18 18 18 
18 18 18 18 18 18 18 18 19 18 18 18 19 18 18 24 8 3 3 3 3 3 3 3 3 3 3 3 3 7 1 25 29 18 18 18 18 18 18 18 18 18 18 18 18 18 18 18 18 18 
18 18 18 18 18 18 18 18 18 18 18 18 18 18 18 24 8 3 3 3 3 3 3 3 3 3 3 3 3 7 2 2 23 18 18 18 18 18 18 18 18 18 18 18 18 18 18 18 18 18 
18 18 18 18 18 18 18 18 18 18 18 18 18 18 18 24 14 5 5 5 5 5 5 5 5 5 5 5 5 15 1 20 31 18 18 18 18 18 18 18 18 18 18 18 18 18 18 18 18 18 
18 18 18 18 18 18 18 18 19 18 18 18 18 18 18 30 21 21 21 21 21 21 21 21 21 21 21 21 21 21 21 31 18 18 18 18 18 18 18 18 18 18 18 18 18 18 18 18 18 18 
18 18 18 18 18 18 18 18 18 18 19 18 18 18 18 18 18 18 18 18 18 18 18 18 18 18 18 18 18 18 18 18 18 18 18 18 18 18 18 18 18 18 18 18 18 18 18 18 18 18 
18 18 18 18 18 18 18 18 18 18 18 18 18 18 19 18 18 18 18 18 18 18 18 18 18 18 18 18 18 18 18 18 18 18 18 18 18 18 18 18 18 18 18 18 18 18 18 18 18 18 
18 18 18 18 18 18 18 18 18 18 18 18 18 18 18 18 18 19 19 18 19 18 18 18 18 18 18 18 18 18 18 18 18 18 18 18 18 18 18 18 18 18 18 18 18 18 18 18 18 18 
18 18 18 18 18 19 18 18 18 19 18 18 18 18 18 18 19 18 18 18 18 18 18 18 18 18 18 19 18 19 18 18 18 18 18 18 18 18 18 18 18 18 18 18 18 18 18 18 18 18 
18 18 18 18 18 18 18 18 18 18 19 19 18 18 18 18 18 19 19 18 19 18 18 18 18 18 18 18 18 18 18 18 18 18 18 18 18 18 18 18 18 18 18 18 18 18 18 18 18 18 
18 18 18 18 18 18 18 18 18 18 18 19 18 18 18 18 18 18 18 18 18 18 18 18 18 18 18 18 18 18 18 18 18 18 18 18 18 18 18 18 18 18 18 18 18 18 18 18 18 18 
18 18 18 18 18 18 18 18 18 19 18 19 18 18 18 18 18 18 18 18 18 18 18 18 18 18 18 18 18 18 18 18 18 18 18 18 18 18 18 18 18 18 18 18 18 18 18 18 18 18 
18 18 18 18 18 19 18 18 18 18 18 18 18 18 18 18 18 18 18 18 19 18 19 18 18 19 19 19 19 18 18 18 18 18 18 18 18 18 18 18 18 18 18 18 18 18 18 18 18 18 
18 18 18 18 19 19 18 18 18 18 18 18 18 18 18 18 18 18 18 18 19 18 18 19 19 19 18 18 18 18 18 18 18 18 18 18 18 18 18 18 18 18 18 18 18 18 18 18 18 18 
18 18 18 18 18 19 18 19 19 19 18 19 19 19 18 18 19 18 19 19 19 19 18 18 18 18 18 18 18 18 18 18 18 18 18 18 18 18 18 18 18 18 18 18 18 18 18 18 18 18 
18 18 18 18 18 18 18 18 18 18 18 18 18 18 18 18 18 18 18 19 18 18 18 18 18 18 18 19 19 18 19 19 18 18 18 18 18 18 18 18 18 18 18 18 18 18 18 18 18 18 
18 18 18 18 18 18 18 18 18 18 18 18 18 18 18 18 18 19 19 18 18 18 18 19 19 18 19 18 18 18 18 18 18 18 18 18 18 18 18 18 18 18 18 18 18 18 18 18 18 18 
18 18 18 18 18 18 18 18 18 18 18 18 18 18 18 18 19 19 19 19 18 19 18 18 18 18 18 18 18 18 18 18 18 18 18 18 18 18 18 18 18 18 18 18 18 18 18 18 18 18 
18 18 18 18 18 18 18 18 18 18 18 18 18 18 18 18 18 18 18 18 18 18 18 18 18 18 18 18 18 18 18 18 18 18 18 18 18 18 18 18 18 18 18 18 18 18 18 18 18 18 
18 18 18 18 18 18 18 18 18 18 18 18 18 18 18 18 18 18 18 18 18 18 18 18 18 18 18 18 18 18 18 18 18 18 18 18 18 18 18 18 18 18 18 18 18 18 18 18 18 18 
18 18 18 18 18 18 18 18 18 18 18 18 18 18 18 18 18 18 18 18 18 18 18 18 18 18 18 18 18 18 18 18 18 18 18 18 18 18 18 18 18 18 18 18 18 18 18 18 18 18 
18 18 18 18 18 18 18 18 18 18 18 18 18 18 18 18 18 18 18 18 18 18 18 18 18 18 18 18 18 18 18 18 18 18 18 18 18 18 18 18 18 18 18 18 18 18 18 18 18 18 
18 18 18 18 18 18 18 18 18 18 18 18 18 18 18 18 18 18 18 18 18 18 18 18 18 18 18 18 18 18 18 18 18 18 18 18 18 18 18 18 18 18 18 18 18 18 18 18 18 18 
